1111111111111111111
10000C00000000000P1
1011111111110111111
101C0000C11101100C1
1010000001E10110101
10000C0000000000001
1111111111111111111
